##################B#
#      #############
##### ##############
####  ##############
#### ###############
     ###############
##  ### ############
#   ################
##      ############
#####  #############
###   ########### ##
# #######  #####  ##
# # ##### ##########
#######   ##########
#       ############
#  ##   ############
# ##################
    ################
 ###################
A###################